#####################################
#****########**********#####*******##
###*****###***######*#****####*****##
####**##****###****##*###***###***#*#
####**####**###*******#*###********##
I***##***#**###*****##**##***#####**#
#***##***********###****##**#####**##
#***##**###*******##****##*****###**F
#*******###***###*********#######***#
#####################################