#####################################
#************###*******####******####
#***##**#######**##***#####*********#
#***##*******###**##*******#**#######
#***##**##**#*******##**###***#**####
I***##**####**######*****#######****#
##**##*******#******###***###*****#*F
##**##############*#####*##*****#**##
#******************##********##****##
#####################################