#####################################
##****####**##***##********##**##***F
##**##***#******####**###**##**###**#
##**##***#**##**##*****##******##**##
##**##***#**##**##**#**##******##**##
I***##***#**##**##*****#####***###*##
##**##***#**##**##*#########****#**##
##**********##*****##**#####***#***##
##**####****##**#########**********##
#####################################