#####################################
#***##*****#****##****##****##******#
#***##****##******#*****#***##******#
#*****##****##****##****##****##****#
#***#***##*****#*****#***##*******###
I***##*****#****##****##****##*****##
#***#*****#******#*****#***##*******#
##**##**###***#**#****#*****#****####
#*****##*****#****##***###****##****F
#####################################