#####################################
#******##**************************##
####***##***##***################ **F
#**#***##***##***###********#####**##  
#**#***##***##***###********##****###
I**#***##***##***############***##*##
#******##***##***###***************##
#**##################***########***##
#*****************************##***##
#####################################
